NORTAV : Température moyenne journalière (°C)
NORTNAV : Température minimale journalière (°C)
NORTXAV : Température maximale journalière (°C)
NORSD : Nombre de journées d'été (jour(s))
NORTX35 : Nombre de jours de fortes chaleur ( TX>35°C ) (jour(s))
NORTXND : Nombre de jours anormalement chauds (jour(s))
NORTNHT : Nombre de nuits anormalement chaudes (jour(s))
NORTR : Nombre de nuits tropicales (jour(s))
NORTNFD : Nombre de jours de gel (jour(s))
NORTNND : Nombre de jours anormalement froids (jour(s))
NORTXFD : Nombre de jours sans dégel (jour(s))
NORTNCWD : Nombre de jours d'une vague de froid (jour(s))
NORTXHWD : Nombre de jours d'une vague de chaleur (jour(s))
NORTRAV : Amplitude thermique journalière (°C)
NORTXQ90 : Extrême chaud de la température maximale journalière (°C)
NORTXQ10 : Extrême froid de la température maximale journalière (°C)
NORTNQ10 : Extrême froid de la température minimale journalière (°C)
NORTNQ90 : Extrême chaud de la température minimale journalière (°C)
NORHDD : degré-jours de chauffage (°C)
NORCDD : degré-jours de climatisation (°C)
NORPAV : Précipitations journalières moyennes (mm)
NORRR : Cumul de précipitation (mm)
NORRR1MM : Nombre de jours de pluie (jour(s))
NORPN20MM : Nombre de jours de fortes précipitations (jour(s))
NORPFL90 : Fraction des précipitations journalières intenses (%)
NORPXCWD : Nombre maximum de jours pluvieux consécutifs (jour(s))
NORPXCDD : Période de sécheresse (jour(s))
NORTPSPI : Temps passé en sécheresse météorologique
NORPINT : Précipitation moyenne les jours pluvieux (mm)
NORPQ90 : précipitations intenses (Q90) (mm)
NORPQ99 : précipitations extrêmes (Q99) (mm)
NORRR99 : nombre de jours de précipitations intenses (nombre de jours où on dépasse le Q99) (jour(s))
NORFFQ98 : vent fort (Q98) (m/s)
NORFF98 : nombre de jours de vent fort (jour(s))
NORHUSAV : Humidité spécifique moyenne (g/kg)
NORETPC : ETP cumulée (mm)
ATAV : Ecart de température moyenne journalière (°C)
ATNAV : Ecart de température minimale journalière (°C)
ATXAV : Ecart de température maximale journalière (°C)
ASD : Ecart de nombre de journées d'été (jour(s))
ATX35 : Ecart de nombre de jours de fortes chaleur ( tx>35°c ) (jour(s))
ATXND : Ecart de nombre de jours anormalement chauds (jour(s))
ATNHT : Ecart de nombre de nuits anormalement chaudes (jour(s))
ATR : Ecart de nombre de nuits tropicales (jour(s))
ATNFD : Ecart de nombre de jours de gel (jour(s))
ATNND : Ecart de nombre de jours anormalement froids (jour(s))
ATXFD : Ecart de nombre de jours sans dégel (jour(s))
ATNCWD : Ecart de nombre de jours d'une vague de froid (jour(s))
ATXHWD : Ecart de nombre de jours d'une vague de chaleur (jour(s))
ATRAV : Ecart de amplitude thermique journalière (°C)
ATXQ90 : Ecart de extrême chaud de la température maximale journalière (°C)
ATXQ10 : Ecart de extrême froid de la température maximale journalière (°C)
ATNQ10 : Ecart de extrême froid de la température minimale journalière (°C)
ATNQ90 : Ecart de extrême chaud de la température minimale journalière (°C)
AHDD : Ecart de degré-jours de chauffage (°C)
ACDD : Ecart de degré-jours de climatisation (°C)
APAV : Ecart de précipitations journalières moyennes (mm)
ARR : Ecart de cumul de précipitation (mm)
ARR1MM : Ecart de nombre de jours de pluie (jour(s))
APN20MM : Ecart de nombre de jours de fortes précipitations (jour(s))
APFL90 : Ecart de fraction des précipitations journalières intenses (%)
APXCWD : Ecart de nombre maximum de jours pluvieux consécutifs (jour(s))
APXCDD : Ecart de période de sécheresse (jour(s))
APINT : Ecart de précipitation moyenne les jours pluvieux (mm)
APQ90 : Ecart de précipitations intenses (q90) (mm)
APQ99 : Ecart de précipitations extrêmes (q99) (mm)
RR99 : Ecart de nombre de jours de précipitations intenses (nombre de jours où on dépasse le q99) (jour(s))
AFFAV : Ecart de vitesse du vent moyenne (m/s)
AFF3 : Ecart de nombre de jours sans vent (<3 m/s) (jour(s))
AFFQ98 : Ecart de vent fort (q98) (m/s)
AFF98 : Ecart de nombre de jours de vent fort (jour(s))
AHUSAV : Ecart de humidité spécifique moyenne (g/kg)
AETPC : Ecart de etp cumulée (mm)
ARPAV : Ecart relatif de précipitations journalières moyennes
ARRR : Ecart relatif de cumul de précipitation
ARPINT : Ecart relatif de précipitation moyenne les jours pluvieux
ARPQ90 : Ecart relatif de précipitations intenses (q90)
ARPQ99 : Ecart relatif de précipitations extrêmes (q99)
ARETPC : Ecart relatif de etp cumulée
